1111111111111
10C00000000P1
1X00000T00001
1000000000001
1111111111111