1111111111111
10C00000000P1
1X0D000T00001
1000000000001
1E00T00000C01
1111111111111