1111111111111111111111111111111111111
1111111111111111111111111111111111111
1001111C11111111C111111111C1111111101
1X00000000000000000000000000000000001
1000000100000000000000000011111111001
1000000000000000010000000011111111001
1E00000000000000000000000011111C11001
1000000000000000000000000011111111001
10000000000000000000000000000000000P1
1111111111111111111111111111111111111