1111111111111111111111111111111111111111111111111111111111111111
10000000000000000000000000000000000000000000C0000000000000000001
10000000000000P0000000000000000000000000000000000000000000000001
1000000110000000000000111111100000000000000111111000000000000001
1000001010000000000000100000100000000000000100000000000000000001
1000010010000000000000010000100000000000000100000000000000000001
1000000010000000000000000001000000000000000111110000000000000001
100000001000000000000000001000000000E000000000001000000000000001
1000000010000000000000000100000000000000000000001000000000000001
1000000010000000000000001000000000000000000000001000000000000001
1000000010000000000000011111000000000000000111110000000000000001
1000000000000000000000000000000000000000000000000000000000000001
1000001100111000000001100010011001111100100101011000100111100001
1000010010101000000001010010100100010000100101010100100100000001
1000010010110000000001001010100100010000111101010010100100100001
1000001100101000000001000110011000010000100101010001100111100001
1000000000000000000000000000000000000000000000000000000000000001
1111111111111111111111111111111111111111111111111111111111111111