11111111111111111111111111111111111111111111
1000001000000000000C11111C000000100000000001
10000010000000000001000001000000100000000001
10000010000000000010000000100000100000000001
10000010000000000100000000010000100000000001
10000010000000000100000000010000100000000001
10000010000000000010000000100000100000000001
10000010000000000001000001000000100000000001
10000011111110000000111110000000111111100001
1E0000000000000000000000000000000000000000P1
11111111111111111111111111111111111111111111