11111111111111111111111111111
10000000000000000000E10CP0001
11111111111111111111111111111