11111111111111111111111111111111111111111111
1C1100000000000000000000000000000000000000E1
10000000000000000000000000000000000000000001
10000000000000000000000000000000000000000001
10000000000000000000000000000000000000000001
1000000000000000000000000000000000C111111111
10000000000000000000001111000000000000000001
100000000000000000000000000000000000000000P1
100000000000000000000C1111000000000000000001
11111111111111111111111111111111111111111111