11111111111111111111
100000000000000000C1
10000000000000000001
10C00000000000000001
10000000000000000001
10000000000000000001
1T0000000X00000000C1
10000000000000000001
10000011111110000001
1C000000000000000001
1E000000000000000001
11111111111111111111