11111111111111111111111111111
1110111110011E110011111000111
11101000000110110000010000111
10001110000110110000100000001
10001000001000001001000000001
10001111100000000011111000001
10000000001111111000000011111
111110101111100C1111111110001
10000010100010101000000000101
100000101010001C1011111111101
1C000010001100111C10000000101
10111111111110000010111110101
10100000000011111110100010101
10101111111000000010100010101
10101000001111111110100010101
101010111C0000000000100010101
10100010111111011111100010101
10C11110000001P1000000001C001
11111111111111111111111111111