1111111111111111111111111111111
1000000000011000000011000000001
10000000001P01000001C0100000001
1000000001000010000100010000001
1000000001000001111000010000001
1000000001100000000000110000001
1000000000011000000011000000001
1000000000000110001100000000001
1000000000000001E10000000000001
1000000000000000100000000000001
1111111111111111111111111111111